11111111111111111111111111111111111111111111111111111111111111111111111111111111
00000100000000010101100000111111100000000001000001111110100000000000000000000001
10110101111111010100001110000000101111111111111100000000101111111011110111111101
10010101000000010111011111111111100000000000010111111110101001000010000000000101
11010111011111110100000000000000101111101111110100000000100011111010111111111111
11010100000000000101111010111110101000000000010101111111101111110010000101010101
11010111101111111101001111100010101111111111010100000000000010000010111100000101
10010000000000000001000000001010101000000000010101111111111111111010010101010101
10010111111111110111111111101110100011111101010100000000010000000010010101010101
10010100000000000000101000000000111111111101010101111111110111111011110101010001
10010101111111111111101010111111110010000101010101000000000100000010000101010101
10011100000000100000101010000000010011110101010101011111111111111011110101010101
10010101111111101111101011111111111010000101010101000100010000000000000001010111
10000100000000000000101010100000010010110100000101010101111111111011111111110101
10010111111111111111101010111111010010110110111101010100000001000010001000010101
10010100000001000000101010100000010000110100000001010101111111111010101111010101
10010101111111011111101010101111110111111101010101010101000110100010101001010001
10010000000000000000001010000000010000000001010101010101010000100000100001000101
11010111111111111111101011111111011111111101010101010001010111111111111111110101
11010000000000000000101000000000000000000001011101010100010000001000000000000111
11000100000111111111111011111111110111111111010101010111111111101011111111110101
11010111111100011100001011110000010000001111010101010111111111101000100101110101
10010000000000000000001000000111110111100001000101010100000000001010000100000000
11111111111111111111111111111111111111111111111111111111111111111111111111111111